NO ./textures/purple_block.xpn
WE ./textures/yellow_block.xpm
EA ./textures/green_block.xpm
SO ./textures/red_block.xpm

F 187,255,146
C 152,255,242

111111111111111
100000000000001
111111100000001
1000000N0000011
111111110000011
100000000000001
100000000000001
101000000000001
111111111111111
