NO ./textures/blue_block.xpm
WE ./textures/yellow_block.xpm
EA ./textures/green_block.xpm
SO ./textures/red_block.xpm

F 187,,142
C 152,255,242

111111111111111
100000000000001
111111100000001
      1N0000011
111111100000001
100000000000001
100000000000001
101000000000001
111111111111111
