NO ./textures/blue_block.xpm
WE ./textures/red_block.xpm
EA ./textures/yellow_block.xpm
SO ./textures/green_block.xpm

F 187,255,146
C 152,255,242

111111
100001
101101
1N0001
111111