NO ./textures/red_block.xpm
WE ./textures/yellow_block.xpm
EA ./textures/green_block.xpm
SO ./textures/blue_block.xpm

F 187,255,146
C 152,255,242

111111111111111
100000100000001
100011100000011
100000100000001
100000000000001
1000000W0000001
101000000000001
111111111111111