NO ./textures/blue_block.xpm
WE ./textures/red_block.xpm
EA ./textures/yellow_block.xpm
SO ./textures/green_block.xpm

F 187,255,146
C 152,255,100

      111111111
      100000001
111111100000011
100000100000001
100000000000001
100000000N00111
1010000000001  
1111111111111  