NO ./textures/red_block.xpm
WE ./textures/yellow_block.xpm
EA ./textures/green_block.xpm
SO ./textures/blue_block.xpm

F 187,255,146
C 152,255,100

      111111111
      100000001
111111100000011
100000100000001
100000000000001
100001110000111
1E1001 1000001 
111111 1111111 