WE ./textures/yellow_block.xpm


    F 187,255,146
EA ./textures/green_block.xpm


C 152,      255,242
                  SO ./textures/blue_block.xpm



 NO ./textures/red_block.xpm

111111111111111
100000000000001
111111100000001
      1N0000011
      100000001
111111111000001
100000000000001
100000000000001
101000000000001
111111111111111